111111111111111111111111111111111111111111111111111111111111111111111111111
10000000000000000000000000001111111000000000000000000000000000C000000000001
111111000000000000000000000000001110000000000000000000000000000000000000001
10000000000000000000110000000000000000E000000000000000001111110000000000001
11111P000000000000000000000000000000000000000000000000000000000000000000001
100000000000000000000000000000000110000000000000000000000000000000000000001
111111111111111111111111111111111111111111111111111111111111111111111111111