11111111111111111
10010000000C00001
10000111110000001
1P0011E0000000111
11111111111111111