11111111111111111111111111
1000000000011000000E000001
10001011000000000000000001
100000110000000C0000000001
1000P00000000000000000E001
11111111111111111111111111