111111111111111111
1000000111100E0001
100C00010000001001
100111100000000101
100C00000111000001
100000000100000001
100000011100000001
10000P000100000001
111111111111111111