11111111111
1P0C0C0C011
100C0E0C001
11111111111