11111111111
1P0C0C1C011
100C0E1C101
11111111111




