11111111
1C011111
1E111111
1CCC1111
1CPC1111
11111111