11111
11P11
1E111
11C01
11111



p