111111111111111111111111111111111111111111111111111111
100000000000000C00000001000000000000000000000000000001
100000000000110C0000000000000000C000000110000000000001
100000000000011111100000000000000000001100000000000001
100000000000000000000000000000000000000000000000000001
10000000P000000000000011110000000000000000011000000001
10000000000C00000000001000000000000000000001000E000001
100000000000000000000000000000000000000000000000000001
100000000000000000000000000000000C00000000000000000011
100000000000000000000001000000000000000000000000000001
100000000000110C00000000000000000000000110000000000001
100000000000011111100000000000000000001100000000000001
100000C00000000000000000000000C00000000000000000000001
1000000000C0000000000011110000000000000000011000000001
100000000000000C00000010000000000000000000010000000001
111111111111111111111111111111111111111111111111111111