111111111111111111111111111111111111111111111111111111
100000000000C000000000010000000000000000C0000000000001
10000000000011000000000000000000C000000110000000000001
100000000000011111100000000000000000001100000000000001
100000000000000000000000000000000000000000000000000001
10000000P000000000000011110000000000000000011000000001
10000000000C000000000010000000000000000000010000000001
1000000000000000000000C0000000000000000000000000000001
10000000000000000000000100000000E000000000000000000001
100000000000110000000000000000000000000110000000000001
100000000000011111100000000000000000001100000000000001
10000000C000000000000000000000000000000000000000000001
100000000000000C00000011110000000000000000011000000001
100000000C00000000000010000000000000000000010000000001
100000000000110000000000000000000000000110000000000001
100000000000011111100000000000000000001100000000000001
10000000C000000000000000000000000000000000000000000001
100000000000000C00000011110000000000000000011000000001
100000000C00000000000010000000000000000000010000000001
100000000000110000000000000000000000000110000000000001
100000000000011111100000000000000000001100000000000001
10000000C000000000000000000000000000000000000000000001
100000000000000C00000011110000000000000000011000000001
100000000C00000000000010000000000000000000010000000001
100000000000110000000000000000000000000110000000000001
100000000000011111100000000000000000001100000000000001
10000000C000000000000000000000000000000000000000000001
100000000000011111100000000000000000001100000000000001
10000000C000000000000000000000000000000000000000000001
100000000000000C00000011110000000000000000011000000001
100000000C00000000000010000000000000000000010000000001
111111111111111111111111111111111111111111111111111111