111111111111111111111111111111
1000000000001111C000000H000001
100000110000001000000000000001
10000011100000000000000P000001
11000000000000E000000000000001
111111111111111111111111111111