111111111111111111111111111111111111111111111111111111
100000000000000000000001000000000000000000000000000001
100000000000110C00000000000000000000000110000000000001
100000000000011111100000000000000000001100000000000001
100000000000000000000000000000000000000000000000000001
10000000P000000000000011110000000000000000011000000001
10000000000000000000001000000000000000000001000E000001
111111111111111111111111111111111111111111111111111111