111111111111111111111111111111
1000C00000001111C0000001111001
100000110000C0000000000C000001
10000011100000000C00000P000001
1100000C000000E000000001110001
111111111111111111111111111111