111111111111111111111111111111
1000000000001111C0000000000001
100000110000001000000000000001
100000111000000000000000000001
11000000000000E000000000000001
111111111111111111111111111111