111111111111111111
1000000000000E0001
111C000000H0001111
100000000000000001
100000000C01111111
100000000000000001
111111100000000001
10000P000000000001
111111111111111111