11111111111111111111111111111
10000000000000000000000000001
111C000000H000000000000000111
10000000010000000000000000001
100000001C1111111000000000001
10000000010000000000000000001
111111100000000000000000E0001
10000P00000000000011100000001
11111111111111111111111111111