11111
11P11
1E011
11C11
11101




