111111111111111111
10000C00C0000E0001
111C000000C0001111
10000C00000C000001
1000C0000C01111111
100C00000000000001
11111110000C000001
10000P00C000C00001
111111111111111111