11111111111111111111111111111111111111
1000000000000000000000000P000000000001
11111100000000000000000000000000000001
11100000000E00000000111110000000000001
11111000000000000000000000000000000001
100000000000000000000000C0000000000001
11111111111111111111111111111111111111